{	"numX": 13,	"numY": 9,	"size": [64, 64],	"start": [32, 32],	"tileNames": ["", "ProtoCoin", "ProtoBox", "Tile01", "ProtoBat", "Tile02", "ProtoPotion"],	"tiles": [3, 0, 0, 0, 0, 0, 0, 0, 0, 0, 0, 0, 5,
			  3, 0, 0, 0, 2, 0, 0, 2, 0, 0, 0, 0, 5,
			  3, 0, 4, 0, 0, 0, 3, 3, 3, 3, 0, 4, 5,
			  3, 5, 6, 2, 1, 1, 0, 1, 1, 0, 0, 3, 5,
			  3, 3, 3, 3, 2, 2, 2, 0, 0, 0, 3, 3, 5,
			  3, 0, 0, 0, 0, 0, 0, 0, 0, 3, 3, 3, 5,
			  3, 0, 0, 0, 0, 0, 0, 0, 3, 3, 3, 3, 5,
			  3, 5, 0, 0, 0, 0, 3, 3, 3, 3, 3, 3, 5,
			  3, 3, 3, 3, 3, 3, 3, 3, 3, 3, 3, 3, 5]
}